Часть 1: Абстрактные классы (5 заданий)
Задание 1: Банковские счета
Создайте абстрактный класс BankAccount с полями:

accountNumber (String) - номер счета
balance (double) - баланс
ownerName (String) - имя владельца

Добавьте:

Конструктор для инициализации всех полей
Конкретный метод deposit(double amount) - пополнение счета
Конкретный метод getBalance() - получение баланса
Абстрактный метод withdraw(double amount) - снятие денег

Создайте два класса-наследника:

SavingsAccount (сберегательный счет) - можно снять деньги только если баланс после снятия останется >= 1000
CurrentAccount (текущий счет) - можно снять любую сумму, даже уйти в минус до -5000


Задание 2: Транспорт
Создайте абстрактный класс Transport с полями:

brand (String) - марка
year (int) - год выпуска
maxSpeed (int) - максимальная скорость

Добавьте:

Конструктор
Конкретный метод displayInfo() - выводит информацию о транспорте
Абстрактный метод move() - описывает как движется транспорт
Абстрактный метод refuel() - описывает как заправляется

Создайте классы-наследники:

Car - move() выводит "Едет по дороге", refuel() выводит "Заправка бензином"
Boat - move() выводит "Плывет по воде", refuel() выводит "Заправка дизелем"



Задание 3: Сотрудники компании
Создайте абстрактный класс employee.Employee с полями:

name (String) - имя
id (int) - ID сотрудника
baseSalary (double) - базовая зарплата

Добавьте:

Конструктор
Абстрактный метод calculateSalary() - возвращает итоговую зарплату
Конкретный метод getInfo() - выводит информацию о сотруднике

Создайте классы-наследники:

Manager - зарплата = baseSalary + 20% бонус
Developer - зарплата = baseSalary + 1000 за каждый завершенный проект (добавьте поле completedProjects)
Intern - зарплата = baseSalary (без надбавок)



Интерфейсы (5 заданий)
Задание 4: Платежные системы
Создайте интерфейс Payable с методами:

processPayment(double amount) - обработка платежа
refundPayment(double amount) - возврат средств
Default метод printReceipt() - выводит "Чек распечатан"

Создайте классы:

CreditCard - реализует Payable
PayPal - реализует Payable
Cash - реализует Payable

Каждый класс должен по-своему реализовать методы платежа.


Задание 5: Умный дом
Создайте интерфейсы:

Controllable с методами: turnOn(), turnOff(), getStatus()
Dimmable с методами: setBrightness(int level), getBrightness()

Создайте классы:

Light - реализует оба интерфейса (Controllable и Dimmable)
Fan - реализует только Controllable
SmartTV - реализует оба интерфейса (яркость экрана)


Задание 6: Хранилища данных
Создайте интерфейс DataStorage с методами:

save(String data) - сохранить данные
load() - загрузить данные (возвращает String)
delete() - удалить данные
Static метод getStorageType() - возвращает "Data Storage System"
Default метод backup() - выводит "Создание резервной копии"

Создайте классы:

FileStorage - работа с файлами
DatabaseStorage - работа с базой данных
CloudStorage - работа с облаком